11111111111
1E110001001
101C0100001
100001C11P1
11111111111
