11111111111
1E110001C01
100C0100001
1C10C10C001
101C0100C01
100001C11P1
11111111111
