1111111111111
1E110001C0111
100C011100101
1C10C1000C101
101C000000C01
10000100C11P1
1111111111111
