11111111111111111111111111111111
1E0C000000000000000000000000C0P1
11111111111111111111111111111111
