111111111111111
1E11000001C0111
100C01100100101
1C10C100000C101
101C00000000C01
1000010000C11P1
111111111111111
111101010001111
111101011101111
11110C010001111
111111010111111
111111010001111
111111111111111
