1111111111111111111111111
1E000000000011000001C0111
100C011011111010100100101
1C10C1000000000000000C101
101C000001111101010000C01
101C01110000C000000000001
101C01111101010C0C0CCC001
101C00011100C00C0C000C001
101C01110000C00CCC0CCC001
101C00111000C0000C0C00001
101C0000111110101C0CCC001
101C001111101010000000001
101C00011100C000111111001
101C00011100C000000000001
10000100111110101000C11P1
111111111111111111111111X
