01111111111
1E110001001
1C1C0100001
100001C11P1
11111111111
