1111111111111111111111111
1E00000000001100000100111
1000011011111010100100101
1010010000000100000000101
1010000001101101010000001
1010011110000000000000001
1010011111010100000000001
1010000111000000000000001
1010011100000000000000001
1010001110000000000000001
1010000011111010100000001
1010001111101010000000001
1010000111000000111111001
1010000111000000000000001
10000100111110101000011P1
1111111111111111111111111
